1,0,0,0,0,0,0,0,1,
0,1,0,0,0,0,0,1,0,
0,0,1,0,0,0,1,0,0,
0,0,0,1,0,1,0,0,0,
0,0,0,0,m,0,0,0,0,
0,0,0,1,0,1,0,0,0,
0,0,1,0,0,0,1,0,0,
0,1,0,0,0,0,0,1,0,
1,0,0,0,0,0,0,0,1,
300, 17,,,,,,,,,
