1,1,1,1,1,1,1,1,1,
0,0,0,0,0,0,0,0,0,
0,h,h,0,0,0,h,h,0,
0,0,0,0,0,0,0,0,0,
0,0,c,0,m,0,e,0,0,
0,0,0,0,0,0,0,0,0,
0,h,h,0,0,0,h,h,0,
0,0,0,0,0,0,0,0,0,
1,1,1,1,1,1,1,1,1,
90, 45,,,,,,,,,
