0,0,s,1,1,1,1,1,0,
0,0,0,0,0,0,0,0,0,
0,1,1,1,1,1,c,0,0,
0,0,0,0,0,0,0,0,0,
0,0,m,1,1,1,1,1,0,
0,0,0,0,0,0,0,0,0,
0,1,1,1,1,1,r,0,0,
0,0,0,0,0,0,0,0,0,
0,0,a,1,1,1,1,0,0,
300, 29,,,,,,,,,
