0,0,0,0,1,0,0,0,0,
0,m,h,1,0,1,h,r,0,
0,h,1,0,0,0,1,h,0,
0,1,0,0,0,0,0,1,0,
1,0,0,0,0,0,0,0,1,
0,1,0,0,0,0,0,1,0,
0,h,1,0,0,0,1,h,0,
0,a,h,1,0,1,h,c,0,
0,0,0,0,1,0,0,0,0,
300, 44,,,,,,,,,
