0,a,0,0,0,0,0,s,0,
a,0,a,0,0,0,s,0,s,
0,0,0,0,h,0,0,0,0,
0,0,0,h,1,h,0,0,0,
0,0,0,1,h,1,0,0,0,
0,0,0,h,0,h,0,0,0,
0,c,0,0,0,0,0,r,0,
c,0,c,0,0,0,r,0,r,
0,0,0,0,0,0,0,0,0,
300, 33,,,,,,,,,
