0,0,0,0,0,0,0,0,0,
0,h,a,s,a,s,a,h,0,
0,0,1,1,1,1,1,0,0,
0,h,0,0,0,0,0,h,0,
0,1,1,1,1,1,1,1,0,
0,h,0,0,0,0,0,h,0,
0,0,1,1,1,1,1,0,0,
0,h,c,r,c,r,c,h,0,
0,0,0,0,0,0,0,0,0,
300, 51,,,,,,,,,
